1111111111111111
1000000000P00011
100000000000E001
1CCCCCCCCCCCCCC1
1111111111111111